5 6 6 6 6 6 6 6 6 6 6 6 6 6 6 6 7
12 0 0 0 0 0 0 0 0 0 0 0 0 0 0 0 8
12 0 0 0 0 0 0 0 0 0 0 0 0 0 0 0 8
12 0 0 0 0 0 0 0 0 0 0 0 0 0 0 0 8
12 0 0 0 0 0 0 0 0 0 0 0 0 0 0 0 8 
12 0 0 0 0 0 0 0 4 0 0 0 0 0 0 0 8
12 0 0 0 0 0 0 4 0 4 0 0 0 0 0 0 8
12 0 0 0 0 0 0 0 4 0 0 0 0 0 0 0 8
12 0 0 0 0 0 0 0 0 0 0 0 0 0 0 0 8
12 0 0 0 0 0 0 0 0 0 0 0 0 0 0 0 8
12 0 0 0 0 0 0 0 0 0 0 0 0 0 0 0 8 
12 0 0 0 0 0 0 0 0 0 0 0 0 0 0 0 8
12 0 0 0 0 0 0 0 0 0 0 0 0 0 0 0 8
12 0 0 0 0 0 0 0 0 0 0 0 0 0 0 0 8
11 10 10 10 10 10 10 10 10 10 10 10 10 10 10 10 9