5 6 6 6 6 6 6 6 6 6 6 6 6 6 6 6 7
12 0 0 0 0 0 0 0 0 0 0 0 0 0 0 0 8
12 0 2 0 2 1 1 2 2 2 2 1 1 1 2 0 8
12 0 1 0 1 0 0 0 0 0 0 0 0 0 1 0 8
12 0 1 0 1 0 2 3 2 2 3 1 2 0 1 0 8 
12 0 2 0 2 0 0 0 4 0 0 0 1 0 2 0 8
12 0 2 0 2 0 3 4 0 4 2 0 1 0 1 0 8
12 0 2 0 2 0 3 0 4 0 0 0 1 0 2 0 8
12 0 2 0 1 0 2 0 3 2 3 0 1 0 2 0 8
12 0 1 0 1 0 0 0 0 0 0 0 1 0 1 0 8
12 0 1 0 2 2 2 1 1 1 1 2 2 0 1 0 8 
12 0 2 0 0 0 0 0 0 0 0 0 0 0 2 0 8
12 0 2 1 2 1 1 2 2 2 2 2 1 1 2 0 8
12 0 0 0 0 0 0 0 0 0 0 0 0 0 0 0 8
11 10 10 10 10 10 10 10 10 10 10 10 10 10 10 10 9